30 30
000000000000000000000000000000
000000000000000000000000000000
000000000000000000000000000000
000111111111111111111111110000
001111111111111111111111111000
000001111111111111111000000000
000111111111111111111111111000
000001111111111111111111111110
001111111111111111111100000000
001111111111111111111111000000
001111111111111111111111000000
001111111111111111111111000000
001111111111111111111111000000
001111111111111111111111000000
001111111111111111111111000000
001111111111111111111111000000
001111111111111111111111000000
001111111111111111111111000000
001111111111111111111111000000
001111111111111111111111000000
001111111111111111111111000000
001111111111111111111111000000
001111111111111111111111000000
001111111111111111111111000000
001111111111111111111111000000
001111111111111111111111000000
000000001111111111111100000000
000000011111111000000000000000
000000000000000000000000000000
000000000000000000000000000000